NO textures/north.xpm
SO textures/south.xpm
EA textures/east.xpm
WE textures/west.xpm
F 0,0,255
C 255,255,0

111111111111111111111111111111
100000000000000000100000000001
100000000011111E00010000000001
10000000001    10000000000001
10000000001    10000000000001
100000000011111100000000000001
10000000000000000000000000001
10000000000000000100000000001
10000010000000001 10000000001
111111 1111111111 11111111111

