NO textures/north.xpm
SO textures/south.xpm
EA textures/east.xpm
WE textures/west.xpm
F 128,128,128
C 0,0,0

1111111111111111111111111
10S0110000100000000000001
1000110010000100111111001
1000110000100000110001001
1000000100100000000001001
1111111111111111111111111
